###########################################################################################################
#                      [0 0]              {! !}              <O O>              |@ @|                     #
#                      --#--              ==*==              ~~#~~              -=|=-                     #
#                       / \                / \                / \                / \                      #
###########################################################################################################
#                                                                                                         #
#                                                                                                         #
#                                                                                                         #
#                                                                                                         #
#                                                                                                         #
#                                                                                                         #
#                                                                                                         #
#                                                                                                         #
#                                                                                                         #
#                                                                                                         #
#                                                                                                         #
#                                                                                                         #
#                                                                                                         #
#                                                                                                         #
#                                                                                                         #
#                                                                                                         #
#                                                                                                         #
#                                                                                                         #
#                                                                                                         #
#                                                                                                         #
#                                                                                                         #
#                                                                                                         #
#                                                                                                         #
#                                                                                                         #
#                                                                                                         #
#                                                                                                         #
#                                                                                                         #
#                                                                                                         #
#                                                                                                         #
#                                                                                                         #
#                                                                                                         #
#                                                                                                         #
#                                                                                                         #
#                                                                                                         #
#                                                                                                         #
#                                                                                                         #
#                                                                                                         #
#                                                                                                         #
#                                                                                                         #
#                                                                                                         #
#                                                                                                         #
#                                                                                                         #
#                                                                                                         #
#                                                                                                         #
#                                                                                                         #
###########################################################################################################