##############################################################################################################
#                                                                                                            #
#                                                                                                            #
#                                                                                                            #
#                                                                                                            #
#                                                                                                            #
#                                                                                                            #
#                                                                                                            #
#                                                                                                            #
#                                                                                                            #
#                                                                                                            #
#                                                                                                            #
#                                                                                                            #
#                                                                                                            #
#                                                                                                            #
#                                                                                                            #
#                                                                                                            #
#                                                                                                            #
#                                                                                                            #
#                                                                                                            #
#                                                                                                            #
#                                                                                                            #
#                                                                                                            #
#                                                                                                            #
#                                                                                                            #
#                                                                                                            #
#                                                                                                            #
#                                                                                                            #
#                                                                                                            #
#                                                                                                            #
#                                                                                                            #
#                                                                                                            #
#                                                                                                            #
#                                                                                                            #
#                                                                                                            #
#                                                                                                            #
#                                                                                                            #
#                                                                                                            #
#                                                                                                            #
#                                                                                                            #
#                                                                                                            #
#                                                                                                            #
#                                                                                                            #
#                                                                                                            #
#                                                                                                            #
#                                                                                                            #
#                                                                                                            #
#                                                                                                            #
#                                                                                                            #
#                                                                                                            #
#                                                                                                            #
#                                                                                                            #
#                                                                                                            #
#                                                                                                            #
##############################################################################################################